%%%%%%%%%%%%%%%%%%%%%
%....%.........%....%
%.%%.%.%%%%%%%.%.%%.%
%.%...............%.%
%.%.%%.%%   %%.%%.%.%
%......%     %......%
%.%.%%.%%%%%%%.%%.%.%
%.%...............%.%
%.%%.%.%%%%%%%.%.%%.%
%....%.........%....%
%%%%%%%%%%%%%%%%%%%%%
