%%%%%%%%%%%%%%%%%%%%%
%o...%.........%....%
%.%%.%.%%%%%%%.%.%%.%
%.%...............%.%
%.%.%%.%%...%%.%%.%.%
%......%.....%......%
%.%.%%.%%%%%%%.%%.%.%
%.%...............%.%
%.%%.%.%%%%%%%.%.%%.%
%....%.........%...o%
%%%%%%%%%%%%%%%%%%%%%
